NO ./textures/north_rock_1.xpm
SO ./textures/south_rock_1.xpm
WE ./textures/west_rock_1.xpm
EA ./textures/east_rock_1.xpm

F 0,255,0
C 0,0,255

1111
10N1
1111